0000000000300000000000
0000000000000000000000
0000000016061000000000
0000000016061000000000
0000000016061000000000
0000000016061000000000
0000001116061110000000
0000001660046610000000
0000001605400610000000
0000001604050610000000
0000001602000610000000
0000001114141110000000
0000000000000000000000