0000000000000000000000
0000000000000000000000
0000000000000000300000
0000000000000000000000
0000020000000000000000
0000011110111010000000
0000000010040010000000
0000000010111010000000
0000000011101010000000
0000000000001110000000
0000000000000000000000
0000000000000000000000
0000000000000000000000