0000000000000000000000
0000000000000000000000
0000000000000000000000
0000000000000000000000
0000000000000000000000
0000000000000030000000
0000000400011110000000
0000000000010000000000
0000002000010000000000
0000001111110000000000
0000000000000000000000
0000000000000000000000
0000000000000000000000