0000000000000000000000
0000000000000000000000
0000000000000000000000
0000000000000000000000
0000000200000000000000
0000000111106110000000
0000000010000130000000
0000000016040100000000
0000000011611100000000
0000000001111000000000
0000000000000000000000
0000000000000000000000
0000000000000000000000