0000000000000000000000
0000000000000000000000
0000000000000000000000
0000000000000000000000
0000000000000000000000
0000000000000003000000
0000000001101111000000
0000000001401000000000
0000020000001000000000
0000011111101000000000
0000000000111000000000
0000000000000000000000
0000000000000000000000