0000000000000000000000
0000000000000000000000
0000000010000000000000
0000000010000000000000
0000000010000000000000
0000005010500003000000
0000001111100001000000
0000040000000001000000
0000000200000001000000
0000101111111001000000
0000111000001111000000
0000000000000000000000
0000000000000000000000