0000000000000000000000
0000000000000000000000
0000000000000000000000
0000000000000000000000
0000000000003000000000
0000000011111000000000
0000000014010000000000
0000200000010000000000
0000111110010000000000
0000000011110000000000
0000000000000000000000
0000000000000000000000
0000000000000000000000