0000000000000000000000
0000000000000000000000
0000000000000000000000
0000000000000000000000
0000000000000000000000
0000000000000000000000
0000000005000000000000
0000000004000006000000
0000002006111601000000
0000001111111103000000
0000000000000000000000
0000000000000000000000
0000000000000000000000