0000000000000000000000
0000000000000000000000
0000000000000000000000
0000000000000000000000
0000000000000101100000
0000000000164103000000
0000000000000101000000
0000200061600111000000
0000111111111100000000
0000000000000000000000
0000000000000000000000
0000000000000000000000
0000000000000000000000