0000000000000000000000
0000000000000000000000
0000000000000000000000
0000000000000000000000
0000000000000000000000
0000020000000030000000
0000011110000010000000
0000010010000010000000
0000010000400010000000
0000011110001110000000
0000000000000000000000
0000000000000000000000
0000000000000000000000