0000000000000000000000
0000000000000000000000
0000000000000000000000
0000000005000000000000
0000000001000000000000
0000000001000000300000
0000000001400000000000
0000002000000000000000
0000001111111100000000
0000000000000000000000
0000000000000000000000
0000000000000000000000
0000000000000000000000