0000000000000000000000
0000000000000000000000
0000000200001000000000
0000000011001000000000
0000000000000000000000
0000000000600600000000
0000000010141110000000
0000000010601030000000
0000000010001000000000
0000000011111000000000
0000000000000000000000
0000000000000000000000
0000000000000000000000