000000000000000
000000000000000
000000000000000
000000000000000
000200000003000
001111111111100
000000000000000
000000000000000
000000000000000
000000000000000