0000000000000000000000
0000000000000000000000
0000000000000000000000
0000000000000003000000
0000000000010000000000
0000000001410000000000
0000000000000000000000
0000000200000500000000
0000000111011100000000
0000000001110000000000
0000000000000000000000
0000000000000000000000
0000000000000000000000