0000000000000000000000
0000000000000000000000
0000000000000000000000
0000000000000000000000
0000000000000000000000
0000000000000000000000
0000000000400000000000
0000000000000000000000
0000200000600000300000
0000111111111111100000
0000000000000000000000
0000000000000000000000
0000000000000000000000